abase :: lower: humiliate
abash :: embarrass
abdicate :: renounce: give up
aberration :: wandering or staying away; in optics, failure of rays to focus
abettor :: encourager
abeyance :: suspended action
abhor :: detest
abjure :: renounce upon oath
ablution :: washing
abnegation :: repudiation; self-sacrifice
abominate :: loathe: hate
aboriginal :: being the first of its kind in a region: primitive: native
abortive :: unsuccessful: fruitless
abrade :: wear away by friction: erode
abrogate :: abolish
abscond :: depart secretly and hide
absolve :: pardon an offense
abstemious :: temperate: sparing in drink, etc.
abstinence :: restraint from eating or drinking
abstruse :: obscure: profound: difficult to understand
abut :: border upon; adjoin
abysmal :: bottomless
accede :: agree
accelerate :: move faster
accessory :: additional object: useful but not essential thing
acclimate :: adjust to climate
acclivity :: sharp upslope of a hill
accolade :: award of merit
accomplice :: partner in crime
accord :: agreement
accost :: approach and speak first to a person
accoutre :: equip
accretion :: growth: increase
accrue :: come about by addition
acephalous :: headless
acerbity :: bitterness of speech and temper
acetic :: vinegary
acidulous :: slightly sour: sharp: caustic
acknowledge :: recognize: admit
acme :: top: pinnacle
acoustics :: science of sound: quality that makes a room easy or hard to hear in
acquiescence :: submission; compliance
acquiescent :: accepting passively
acquittal :: deliverance from a charge
acrid :: sharp: bitterly pungent
acrimonious :: stinging: caustic
actuarial :: calculating; pertaining to insurance statistics
actuate :: motivate
acumen :: mental keenness
adage :: wise saying: proverb
adamant :: hard: inflexible
adapt :: alter: modify
addiction :: compulsive, habitual need
addle :: rotten: muddled; crazy
adduce :: present as evidence
adept :: expert at
adhere :: stick fast to
adipose :: fatty
adjunct :: something attached to but holding an inferior position
adjuration :: solemn urging
adjure :: request solemnly
admonish :: warn: reprove
admonition :: warning
adroit :: skillful
adulation :: flattery: admiration
adulterate :: make impure by mixing with baser substances
adulterated :: made impure or spoiled by the addition of inferior materials
adumbration :: foreshadowing: outlining
advent :: arrival
adventitious :: accidental: casual
adverse :: unfavorable: hostile
adversity :: poverty: misfortune
advert :: refer to
advocate :: urge: plead for
aegis :: shield; defense
aeon :: long period of time; an age
aesthetic :: artistic: dealing with or capable off appreciation of the beautiful
affable :: courteous
affected :: artificial: pretended
afferent :: carrying toward the center
affidavit :: written statement made under oath
affiliation :: joining: associating with
affinity :: kinship
affirmation :: solemn pledge by one who refuses to take an oath
afflatus :: inspiration
affluence :: abundance: wealth
affray :: public brawl
agape :: openmouthed
agenda :: items of business at a meeting
agglomeration :: collection: heap
aggrandize :: increase or intensify
aggregate :: sum: total
aghast :: horrified
agility :: nimbleness
agitate :: stir up: disturb
agitation :: strong feeling; excitement
agnostic :: one who is skeptical of the existence or knowability of a god
agrarian :: pertaining to land or its cultivation
agronomist :: scientist engaged in the management of land
alacrity :: cheerful promptness
albeit :: although
alchemy :: medieval chemistry
alias :: an assumed name
alienate :: make hostile: separate
alimentary :: supplying nourishment
alimony :: payment by a husband to his divorced wife
allay :: calm: pacify
allege :: state without proof
allegory :: story in which characters are used as symbols: fable
alleviate :: relieve
alliteration :: repetition of beginning sound in poetry
allocate :: assign
alloy :: a mixture as of metals
allude :: refer indirectly
allusion :: indirect reference
alluvial :: pertaining to soil deposits left by rivers, etc.
aloof :: apart; reserved
altercation :: wordy quarrel
altruism :: unselfish aid to others; generosity
amalgamate :: combine; unite in one body
amass :: collect
amazon :: female warrior
ambiguous :: doubtful in meaning
amble :: move at an easy pace
ambrosia :: food of the gods
ambulatory :: able to walk
ameliorate :: improve
amenable :: readily managed; willing to be led
amenities :: agreeable manners; courtesies
amiable :: agreeable; lovable
amicable :: friendly
amnesia :: loss of memory
amnesty :: pardon
amoral :: nonmoral
amorphous :: shapeless
amortization :: act of reducing a debt through partial payments
amphibian :: able to live both on land in water
amphitheater :: oval building with tiers of seats
ample :: abundant
amplify :: enlarge
amputate :: cut off part of body; prune
amuck :: in a state of rage
amulet :: charm; talisman
anachronism :: an error involving time in a story
analgesic :: causing insensitivity to pain
analogous :: comparable
analogy :: similarity; parallelism
anarchy :: absence of governing body; state of disorder
anathema :: solemn curse
ancestors rather than to parents
ancillary :: serving as an aid or accessory; auxiliary
andirons :: metal supports in a fireplace for cooking utensils or logs
anemia :: condition in which blood lacks red corpuscles
anesthetic :: substance that removes sensation with or without loss of consciousness
animadversion :: critical remark
animated :: lively
animosity :: active enmity
animus :: hostile feeling or intent
annals :: records; history
anneal :: reduce brittleness and improve toughness by heating and cooling
annihilate :: destroy
annotate :: comment; make explanatory notes
annuity :: yearly allowance
annul :: make void
anomalous :: abnormal; irregular
anomaly :: irregularity
anonymous :: having no name
antagonism :: active resistance
antediluvian :: antiquated; ancient
anthropoid :: manlike
anthropologist :: a student of the history and science of mankind
anthropomorphic :: having human form or characteristics
anticlimax :: letdown in thought or emotion
antipathy :: aversion; dislike
antiseptic :: substance that prevents infection
antithesis :: contrast; direct opposite of or to
apathetic :: indifferent
aperture :: opening; hole
apex :: tip; summit; climax
aphasia :: loss of speech due to injury
aphorism :: pithy maxim
apiary :: a place where bees are kept
aplomb :: poise
apocalyptic :: prophetic; pertaining to revelations
apocryphal :: not genuine; sham
apogee :: highest point
apologue :: moral fable
apostate :: one who abandons his religious faith or political beliefs
apothecary :: druggist
apothegm :: pithy, compact saying
apotheosis :: deification; glorification
apparition :: ghost; phantom
appease :: pacify; soothe
appellation :: name; title
append :: attach
apposite :: appropriate; fitting
appraise :: estimate value of
apprehend :: arrest a criminal; dread; perceive
apprehensive :: fearful; discerning
apprise :: inform
appurtenances :: subordinate possessions
apropos :: with reference to; properly
aptitude :: fitness; talent
aquiline :: curved; hooked
arable :: fit for plowing
arbiter :: a person with power to decide a dispute; judge
arbitrary :: fixed or decided; despotic
arcade :: a covered passageway, usually lined with shops
archaeology :: study of artifacts and relics of early mankind
archaic :: antiquated
archetype :: prototype; primitive pattern
archipelago :: group of closely located islands
archives :: public records; place where public records are kept
ardor :: heat; passion; zeal
arduous :: hard; strenuous
argot :: slang
aromatic :: fragrant
arraign :: charge in court; indict
arrant :: thorough; complete; unmitigated
arrogance :: haughtiness
arrogate :: claim without reasonable grounds
arroyo :: gully
artifacts :: products of primitive culture
artifice :: deception; trickery
artisan :: a manually skilled worker
ascertain :: find out for certain
ascetic :: practicing self-denial; austere
asceticism :: doctrine of self-denial
ascribe :: refer; attribute; assign
aseptic :: preventing putrefaction or
ashen :: ash-colored
asinine :: stupid
askance :: with a sideway or indirect look
askew :: crookedly; slanted; at an angle
asperity :: sharpness of temper
aspersion :: slanderous remark
aspirant :: seeker after position or status
aspiration :: noble ambition
assail :: assault
assay :: analyze; evaluate
asseverate :: make a positive
assiduous :: diligent
assimilate :: absorb; cause to become homogeneous
assuage :: ease; lessen pain
asteroid :: small planet
astigmatism :: eye defect which prevents proper focus
astral :: relating to the stars
astringent :: binding; causing contraction
astute :: wise; shrewd
atavism :: resemblance to remote
atelier :: workshop; studio
atheistic :: denying the existence of God
athwart :: across; in opposition
atrocity :: brutal deed
atrophy :: wasting away
attenuate :: make thin; weaken
attest :: testify; bear witness
attribute :: essential quality
attrition :: gradual wearing down
atypical :: not normal
audacity :: boldness
audit :: examination of accounts
augment :: increase
augury :: omen; prophecy
aureole :: sun's corona; halo
auroral :: pertaining to the aurora borealis
auscultation :: act of listening to the heart or lungs to discover abnormalities
auspicious :: favoring success
austere :: strict; stern
austerity :: sternness; severity
authenticate :: prove genuine
autocrat :: monarch with supreme power
automaton :: mechanism which imitates actions of humans
autonomous :: self-governing
autopsy :: examination of a dead body; postmortem
auxiliary :: helper, additional or subsidiary
avarice :: greediness for wealth
avatar :: incarnation
aver :: state confidently
averse :: reluctant
avid :: greedy; eager for
avocation :: secondary or minor occupation
avouch :: affirm; proclaim
avow :: declare openly
avuncular :: like an uncle
awe :: solemn wonder
awry :: distorted; crooked
axiom :: self-evident truth requiring no proof
azure :: sky blue