earthy :: unrefined; coarse
ebullient :: showing excitement; overflowing with enthusiasm
eccentricity :: oddity; idiosyncrasy
ecclesiastic :: pertaining to the church
éclat :: brilliance; glory
eclecticism :: selection of elements from various sets of opinions or systems
ecstasy :: rapture; joy; any overpowering emotion
edify :: instruct; correct morally
educe :: draw forth; elicit
eerie :: weird
efface :: rub out
effectual :: efficient
effeminate :: having womanly traits
effervesce :: bubble over; show excitement
effete :: worn out; exhausted; barren
efficacy :: power to produce desired effect
effigy :: dummy
efflorescent :: flowering
effluvium :: noxious smell
effrontery :: shameless boldness
effulgent :: brilliantly radiant
effusion :: pouring forth
effusive :: pouring forth; gushing
egoism :: excessive interest in one's self
egotism :: conceit; vanity
egregious :: gross; shocking
egress :: exit
ejaculation :: exclamation
elation :: a rise in spirits; exaltation
elegiacal :: like an elegy; mournful
elicit :: draw out by discussion
elucidate :: explain; enlighten
elusive :: evasive; baffling; hard to grasp
elusory :: tending to deceive expectations; elusive
emaciated :: thin and wasted
emanate :: issue forth
emancipate :: set free
embellish :: adorn
embezzlement :: stealing
emblazon :: deck in brilliant colors
embroil :: throw into confusion; involve in strife; entangle
embryonic :: undeveloped; rudimentary
emend :: correct; correct by a critic
emendation :: correction of errors; improvement
emeritus :: retired but retained in an honorary capacity
emetic :: substance causing vomiting
eminent :: high; lofty
emollient :: soothing or softening remedy
emolument :: salary; compensation
empirical :: based on experience
empyreal :: celestial; fiery
emulate :: rival; imitate
enamored :: in love
enclave :: territory enclosed within an alien land
encomiastic :: praising; eulogistic
encomium :: praise; eulogy
encompass :: surround
encroachment :: gradual intrusion
encumber :: burden
endearment :: fond statement
endemic :: prevailing among a specific group of people or in a specific area
endive :: species of leafy plant used in salads
endue :: provide with some quality; endow
energize :: invigorate; make forceful and active
enervate :: weaken
engender :: cause; produce
engross :: occupy fully
enhance :: advance; improve
enigma :: puzzle
enigmatic :: obscure; puzzling
enjoin :: command; order; forbid
ennui :: boredom
enormity :: hugeness (in a bad sense)
enrapture :: please intensely
ensconce :: settle comfortably
ensue :: follow
enthrall :: capture; enslave
entity :: real being
entomology :: study of insects
entree :: entrance
entrepreneur :: businessman; contractor
environ :: enclose; surround
ephemeral :: short-lived; fleeting
epicure :: connoisseur of food and drink
epicurean :: person who devotes himself to pleasure of the senses
epigram :: witty thought or saying, usually short
epilogue :: short speech at conclusion of dramatic work
epitaph :: inscription in memory of a dead person
epithet :: descriptive word or phrase
epitome :: summary; concise abstract
epoch :: period of time
equable :: tranquil; steady; uniform
equanimity :: calmness of temperament
equestrian :: rider on horseback
equinox :: period of equal days and nights; the beginning of Spring and Autumn
equipage :: horse-drawn carriage
equitable :: fair; impartial
equity :: fairness; justice
equivocal :: doubtful; ambiguous
equivocate :: lie; mislead; attempt to
erode :: eat away
erotic :: pertaining to passionate love
errant :: wandering
erudite :: learned; scholarly
erudition :: high degree of knowledge and learning
escapade :: prank; flighty conduct
eschew :: avoid
escutcheon :: shield-shaped surface on which coat of arms is placed
esoteric :: known only to the chosen few
espionage :: spying
esprit de corps :: comradeship; spirit
estranged :: separated
etc.) into effective action
ethereal :: light; heavenly; fine
ethnic :: relating to races
ethnology :: study of man
etymology :: study of derivation,
eugenic :: pertaining to the improvement of race
eulogistic :: praising
eulogy :: praise
euphemism :: mild expression in place of an unpleasant one
euphonious :: pleasing in sound
evanescent :: fleeting; vanishing
evasive :: not frank; eluding
evince :: show clearly
eviscerate :: disembowel; remove entrails
evoke :: call forth
ewer :: water pitcher
ex officio :: by virtue of one's office
exacerbate :: worsen; embitter
exaction :: exorbitant demand; extortion
exaggerated report
exasperate :: vex
exchequer :: treasury
excision :: act of cutting away
excoriate :: flay; abrade
exculpate :: clear from blame
execrable :: very bad
execrate :: curse; express abhorrence for
exegesis :: explanation, especially of Biblical passages
exemplary :: serving as a model; outstanding
exhort :: urge
exhume :: dig out of the ground;
exigency :: urgent situation
exiguous :: small; minute
exodus :: departure
exonerate :: acquit; exculpate
exorbitant :: excessive
exorcise :: drive out evil spirits
exotic :: not native; strange
expatiate :: talk at length
expatriate :: exile; someone who has withdrawn from his native land
expediency :: that which is advisable or practical
expeditiously :: rapidly and efficiently
expiate :: make amends for a sin
expletive :: interjection; profane oath
explicit :: definite; open
expostulation :: remonstrance
expunge :: cancel; remove
expurgate :: clean; remove offensive parts of a book
extant :: still in existence
extemporaneous :: not planned; impromptu
extenuate :: weaken mitigate
extirpate :: root up
extol :: praise; glorify
extort :: wring from; get money by threats, etc.
extradition :: surrender of prisoner by one state to another
extraneous :: not essential; external
extricate :: free; disentangle
extrinsic :: external; not inherent; foreign
extrovert :: person interested mostly in external objects and actions
extrude :: force or push out
exuberant :: abundant; effusive; lavish
exude :: discharge; give forth