fabricate :: build; lie
facade :: front of the building
facet :: small plane surface of a gem; a side
facetious :: humorous; jocular
facile :: easy; expert
facilitate :: make less difficult
faction :: party; clique; dissension
factious :: inclined to form factions; causing dissension
factitious :: artificial; sham
factotum :: handyman; person who does all kinds of work
fain :: gladly
fallacious :: misleading
fallible :: liable to err
fallow :: plowed but not sowed; uncultivated
fanaticism :: excessive zeal
fancied :: imagined; unreal
fancier :: breeder or dealer of animals
fanciful :: whimsical; visionary
fanciful; mystical
fanfare :: call by bugles or trumpets
fantastic :: unreal; grotesque; whimsical
fastidious :: difficult to please; squeamish
fatalism :: belief that events are determined by forces beyond one's control
fatuous :: foolish; inane
fauna :: animals of a period or region
faux pas :: an error or slip in manners or behavior
fawning :: courting favor by cringing and flattering
fealty :: loyalty; faithfulness
feasible :: practical
febrile :: feverish
fecundity :: fertility; fruitfulness
feeling such as pain, disgust, etc.
feign :: pretend
feint :: trick; shift; sham blow
felicitous :: apt; suitably expressed; well chosen
fell :: cruel; deadly
ferment :: agitation; commotion
ferret :: drive or hunt out of hiding
fervent :: ardent; hot
fervid :: ardent
fervor :: glowing ardor
fester :: generate pus
fete :: honor at a festival
fetid :: malodorous
fetish :: object supposed to possess magical powers; an object of special devoti
fetter :: shackle
fiasco :: total failure
fiat :: command
fickle :: changeable; faithless
fictitious :: imaginary
fidelity :: loyalty
fiduciary :: pertaining to a position of trust
figment :: invention; imaginary thing
filch :: steal
filial :: pertaining to a son daughter
finale :: conclusion
finesse :: delicate skill
finicky :: too particular; fussy
finite :: limited
fissure :: crevice
fitful :: spasmodic; intermittent
flaccid :: flabby
flagellate :: flog; whip
flagging :: weak; drooping
flagrant :: conspicuously wicked
flail :: thresh grain by hand; strike or slap
flair :: talent
flamboyant :: ornate
flaunt :: display ostentatiously
flay :: strip off skin; plunder
fleck :: spot
fledgling :: inexperienced
flick :: light stroke as with a whip
flight from Mecca the Medina
flinch :: hesitate; shrink
flippancy :: trifling gaiety
floe :: mass of floating ice
flora :: plants of a region or era
florid :: flowery; ruddy
flotilla :: small fleet
flotsam :: drifting wreckage
flout :: reject; mock
fluctuation :: wavering
fluency :: smoothness of speech
fluster :: confuse
fluted :: having vertical parallel grooves (as in a pillar)
flux :: flowing; series of changes
foible :: weakness; slight fault
foist :: insert improperly; palm off
foment :: stir up; instigate
foolhardy :: rash
foppish :: vain about dress and appearance
foray :: raid
forbearance :: patience
foreboding :: premonition of evil
forensic :: suitable to debate or courts of law
formidable :: menacing; threatening
forte :: strong point of special talent
fortitude :: bravery; courage
fortuitous :: accidental; by chance
foster :: rear; encourage
fracas :: brawl; melee
fractious :: unruly
frailty :: weakness
franchise :: right granted by authority
frantic :: wild
fraudulent :: cheating; deceitful
fraught :: filled
fray :: brawl
freebooter :: buccaneer
frenetic :: frenzied; frantic
frenzied :: madly excited
fresco :: painting on plaster (usually fresh)
freshet :: sudden flood
friction :: clash in opinion; rubbing against
frieze :: ornamental band on a wall
frigid :: intensely cold
fritter :: waste
frolicsome :: prankish; gay
frond :: fern leaf; palm or banana leaf
froward :: disobedient; perverse; stubborn
frowzy :: slovenly; unkempt; dirty
fructify :: bear fruit
frugality :: thrift
fruition :: bearing of fruit; fulfillment; realization
frustrate :: thwart; defeat
fulcrum :: support on which a lever rests
fulgent :: beaming; radiant
fulminate :: thunder; explode
fulsome :: disgustingly excessive
functionary :: official
funereal :: sad; solemn
furor :: frenzy; great excitement
furtive :: stealthy
fusion :: union; coalition
fustian :: pompous; bombastic