iconoclastic :: attacking cherished traditions
ideology :: ideas of a group people
idiom :: special usage in language
idiosyncrasy :: peculiarity; eccentricity
idiosyncratic :: private; peculiar to an individual
idolatry :: worship of idols; excessive admiration
igneous :: produced by fire; volcanic
ignoble :: of lowly origin; unworthy
ignominious :: disgraceful
illimitable :: infinite
illusion :: misleading vision
illusive :: deceiving
imbecility :: weakness of mind
imbibe :: drink in
imbroglio :: a complicated situation;
imbrue :: drench, stain, especially with blood
imbue :: saturate; fill
immaculate :: pure; spotless
imminent :: impending; near at hand
immobility :: state of being immovable
immolate :: offer as a sacrifice
immune :: exempt
immure :: imprison; shut up in confinement
immutable :: unchangeable
impair :: worsen; diminish in value
impale :: pierce
impalpable :: imperceptible; intangible
impasse :: predicament from which there is no escape
impassive :: without feeling; not affected by pain
impeach :: charge with crime in office; indict
impeccable :: faultless
impecunious :: without money
impending :: nearing; approaching
impenitent :: not repentant
imperious :: domineering
impermeable :: impervious; not permitting passage through its substance
impertinent :: insolent
imperturbability :: calmness
imperturbable :: calm; placid
impervious :: not penetrable; not permitting passage through
impetuous :: violent; hasty; rash
impetus :: moving force
impiety :: irreverence; wickedness
impious :: irreverent
implacable :: incapable of being pacified
implement :: supply what is needed; furnish with tools
implication :: that which is hinted at or suggested
implicit :: understood but not stated
imply :: suggest a meaning not expressed; signify
impolitic :: not wise
imponderable :: weightless
import :: significance
importunate :: urging; demanding
importune :: beg earnestly
impotent :: weak; ineffective
imprecate :: curse; pray that evil will befall
impregnable :: invulnerable
imprimatur :: permission to print or publish a book
impromptu :: without previous preparation
impropriety :: state of being
improvident :: thriftless
improvise :: compose on the spur of the moment
impugn :: doubt; challenge; gainsay
impunity :: freedom from punishment
imputation :: charge; reproach
impute :: attribute; ascribe
inadvertence :: oversight; carelessness
inalienable :: not to be taken away; nontransferable
inane :: silly; senseless
inanimate :: lifeless
inappropriate
inarticulate :: speechless; producing indistinct speech
incantation :: singing or chanting of magic spells; magical formula
incapacitate :: disable
incarcerate :: imprison
incarnadine :: stain crimson or bloodcolor
incarnate :: endowed with flesh; personified
incarnation :: act of assuming a human body and human nature
incendiary :: arsonist
incentive :: spur; motive
incessant :: uninterrupted
inchoate :: recently begun; rudimentary; elementary
incidence :: falling on a body; a casual occurrence
incipient :: beginning; in an early stage
incisive :: cutting; sharp
incite :: arouse to action
inclement :: stormy; unkind
inclusive :: tending to include all
incognito :: with identity concealed; using an assumed name
incommodious :: not spacious
incompatible :: inharmonious
incongruity :: lack of harmony; absurdity
incongruous :: not fitting; absurd
inconsequential :: of trifling significance
incontinent :: lacking self-restraint; licentious
incontrovertible :: indisputable
incorporeal :: immaterial; without a material body
incorrigible :: uncorrectable
incredulity :: a tendency to disbelief
incredulous :: withholding belief; skeptical
increment :: increase
incriminate :: accuse
incubate :: hatch; scheme
incubus :: burden; mental care; nightmare
inculcate :: teach
incumbent :: officeholder
incursion :: temporary invasion
indefatigable :: tireless
indemnify :: make secure against loss; compensate for loss
indenture :: bind as servant or apprentice to master
indict :: charge
indigenous :: native
indigent :: poor
indignity :: offensive or insulting treatment
indisposed to move
indisputable :: too certain to be disputed
indite :: write; compose
indolence :: laziness
indomitable :: unconquerable
indubitably :: beyond a doubt
inductive :: pertaining to induction or
indulgent :: humoring; yielding; lenient
inebriety :: habitual intoxication
ineffable :: unutterable; cannot be expressed in speech
ineluctable :: irresistible; not to be escaped
inept :: unsuited; absurd; incompetent
inertia :: state of being inert or
inexorable :: relentless; unyielding; implacable
infallible :: unerring
infamous :: notoriously bad
infer :: deduce; conclude
inference :: conclusion drawn from data
infinitesimal :: very small
infirmity :: weakness
inflated :: enlarged with air or gas
influx :: flowing into
information in tabular or book form
infraction :: violation
infringe :: violate; encroach
ingenue :: an artless girl; an actress who plays such parts
ingenuous :: naive; young; unsophisticated
ingrate :: ungrateful person
ingratiate :: become popular with
inherent :: firmly established by nature or habit
inhibit :: prohibit; restrain
inimical :: unfriendly; hostile
iniquitous :: unjust; wicked
inkling :: hint
innate :: inborn
innocuous :: harmless
innovation :: change; introduction off something new
innuendo :: hint; insinuation
inordinate :: unrestrained; excessive
insatiable :: not easily satisfied; greedy
inscrutable :: incomprehensible; not to be discovered
insensate :: without feeling
insidious :: treacherous; stealthy; sly
insinuate :: hint; imply
insipid :: tasteless; dull
insolent :: haughty and contemptuous
insolvency :: bankruptcy; lack of ability to repay debts
insomnia :: wakefulness; inability to sleep
insouciant :: indifferent; without concern or care
instigate :: urge; start; provoke
insular :: like an island; narrow-minded
insuperable :: insurmountable; invincible
insurgent :: rebellious
integrate :: make whole; combine; make into one unit
integrity :: wholeness; purity; uprightness
integument :: outer covering or skin
intellect :: higher mental powers
intelligentsia :: the intelligent and educated classes (often used derogatorily)
inter :: bury
interdict :: prohibit; forbid
interim :: meantime
interlocutory :: conversational;
intermediate, not final
interment :: burial
interminable :: endless
intermittent :: periodic; on and off
internecine :: mutually destructive
interstices :: chinks; crevices
intimate :: hint
intimidation :: fear
intractable :: unruly; refractory
intransigence :: state of stubborn unwillingness to compromise
intransigent :: refusing any compromise
intrepid :: fearless
intrinsic :: belonging to a thing in itself; inherent
introvert :: inclined to think more about oneself
introvert :: one who is introspective
intrude :: trespass; enter as an uninvited person
intuition :: power of knowing without reasoning
inundate :: overflow; flood
inured :: accustomed; hardened
invalidate :: weaken; destroy
invective :: abuse
inveigh :: denounce; utter censure or invective
inveigle :: lead astray; wheedle
inverse :: opposite
inveterate :: deep-rooted; habitual
invidious :: designed to create ill will or envy
inviolability :: security from being destroyed, corrupted or profaned
invulnerable :: incapable of injury
iota :: very small quantity
irascible :: irritable; easily angered
iridescent :: exhibiting rainbow like colors
irksome :: repetitious; tedious
ironical :: resulting in an unexpected and contrary manner
irony :: hidden sarcasm or satire
irreconcilable :: incompatible; not able to be resolved
irrefragable :: not to be disproved; indisputable
irrelevant :: not applicable; unrelated
irremediable :: incurable; uncorrectable
irreparable :: not able to be corrected or repaired
irreverent :: lacking proper respect
irrevocable :: unalterable
isotope :: varying form of an element
iterate :: utter a second time; repeat
itinerant :: wandering; traveling
itinerary :: plan of a trip