rabid :: like a fanatic; furious
ragamuffin :: person wearing tattered clothes
ramification :: branching out; subdivision
ramify :: divide into branches or subdivisions
ramp :: slope; inclined plane
rampant :: rearing up on hind legs; unrestrained
rampart :: defensive mound of earth
rancid :: having the odor of stale fat
rancor :: bitterness; hatred
rant :: rave; speak bombastically
rapacious :: excessively grasping; plundering
rapprochement :: reconciliation
rarefied :: made less dense of a gas
ratiocination :: reasoning; act of drawing conclusions from premises
rationalization :: bringing into conformity with reason
rationalize :: reason; justify an improper act
raucous :: harsh and shrill
ravage :: plunder; despoil
ravening :: rapacious; seeking prey
ravenous :: extremely hungry
raze :: destroy completely
reactionary :: recoiling from progress; retrograde
realm :: kingdom; sphere
rebate :: discount
recalcitrant :: obstinately stubborn
recant :: repudiate; withdraw previous statement
recapitulate :: summarize
recession :: withdrawal; retreat
recherché :: choice, sought after; rare
recidivism :: habitual return to crime
recipient :: receiver
reciprocal :: mutual; exchangeable; interacting
reciprocate :: repay in kind
recluse :: hermit
reconcile :: make friendly after quarrel; correct inconsistencies
recondite :: abstruse; profound; secret
reconnaissance :: survey of enemy by soldiers; reconnoitering
recourse :: resorting to help when in trouble
recreant :: coward; betrayer of faith
recrimination :: countercharges
recrudescence :: reopening of a wound or sore
rectify :: correct
rectitude :: uprightness
recumbent :: reclining; lying down completely or in part
recuperate :: recover
recurrent :: occurring again and again
recusant :: person who refuses to comply
redolent :: fragrant; odorous; suggestive of an odor
redoubtable :: formidable; causing fear
redress :: remedy; compensation
redundant :: superfluous; excessively wordy; repetitious
reek :: emit odor
refection :: slight refreshment
refectory :: dinning hall
refraction :: bending of a ray of light
refractory :: stubborn; unmanageable
refulgent :: radiant
refurbish :: renovate; make bright by polishing
refutation :: disproof of opponents' arguments
regal :: royal
regale :: entertain
regatta :: boat or yacht race
regeneration :: spiritual rebirth
regime :: method or system of government
regimen :: prescribed diet and habits
rehabilitate :: restore to proper condition
reimburse :: repay
reiterate :: repeat
rejuvenate :: make young again
relegate :: banish; consign to inferior position
relevancy :: pertinence; reference to the case in hand
relinquish :: abandon
relish :: savor; enjoy
remediable :: reparable
remedial :: curative; corrective
reminiscence :: recollection
remiss :: negligent
remnant :: remainder
remonstrate :: protest
remove from a grave
remunerative :: compensating; rewarding
rend :: split; tear apart
render :: deliver; provide; represent
rendezvous :: meeting place
rendition :: translation; artistic interpretation of a song, etc.
renegade :: deserter; apostate
renounce :: abandon; discontinue; disown; repudiate
renovate :: restore to good condition; renew
renunciation :: giving up; renouncing
reparable :: capable of being repaired
reparation :: amends; compensation
repartee :: clever reply
repellent :: driving away; unattractive
repercussion :: rebound; reverberation; reaction
repertoire :: list of works of music, drama, etc., a performer is prepared to presen
replenish :: fill up again
replete :: filled to capacity; abundantly supplied
replica :: copy
repository :: storehouse
reprehensible :: deserving blame
reprieve :: temporary stay
reprimand :: reprove severely
reprisal :: retaliation
reprobate :: person hardened in sin, devoid of a sense of decency
reprobation :: severe disapproval
reprove :: censure; rebuke
repudiate :: disown; disavow
repugnance :: loathing
requiem :: mass for the dead; dirge
requisite :: necessary requirement
requite :: repay; revenge
rescind :: cancel
rescission :: abrogation; annulment
residue :: remainder; balance
resilient :: elastic; having the power of springing back
resonant :: echoing; resounding; possessing resonance
respite :: delay in punishment; interval of relief; rest
resplendent :: brilliant; lustrous
restitution :: reparation; indemnification
restive :: unmanageable; fretting under control
resurgent :: rising again after defeat, etc.
resuscitate :: revive
retaliate :: repay in kind usually for bad treatment
retentive :: holding; having a good memory
reticence :: reserve; uncommunicativeness; inclination to be silent
reticulated :: covered with a network; having the appearance of a mesh
retinue :: following; attendants
retraction :: withdrawal
retribution :: vengeance; compensation; punishment for offenses
retrieve :: recover; find and bring in
retroactive :: of a law which dates back to a period before its enactment
retrograde :: going backwards; degenerating
revelry :: boisterous merrymaking
reverberate :: echo; resound
reverie :: daydream; musing
revile :: slander; vilify
revulsion :: sudden violent change of feeling; reaction
rhetoric :: art of effective communication; insincere language
rheumy :: pertaining to a discharge from nose and eyes
ribald :: wanton; profane
rife :: abundant; current
rift :: opening; break
rigor :: severity
rime :: white frost
risible :: inclined to laugh; ludicrous
risqué :: verging upon the improper; off-color
roan :: brown mixed with gray or white
robust :: vigorous; strong
rococo :: ornate; highly decorated
rood :: crucifix
roseate :: rosy; optimistic
rossify :: change or harden into bone
rostrum :: platform for speech-making; pulpit
rote :: repetition
rotunda :: circular building or hall covered with a dome
rotundity :: roundness; sonorousness of speech
rubble :: fragments
rubicund :: having a healthy reddish color; ruddy; florid
ruddy :: reddish; healthy-looking
rudimentary :: not developed; elementary
rueful :: regretful; sorrowful; dejected
ruminate :: chew the cud; ponder
rummage :: ransack; thoroughly search
ruse :: trick; stratagem
rustic :: pertaining to country people; uncouth
rusticate :: banish to the country; dwell in the country
ruthless :: pitiless